  ______                            _   _            __  __               
 |  ____|                          | | | |          |  \/  |              
 | |__   ___  ___ __ _ _ __   ___  | |_| |__   ___  | \  / | __ _ _______ 
 |  __| / __|/ __/ _` | '_ \ / _ \ | __| '_ \ / _ \ | |\/| |/ _` |_  / _ \
 | |____\__ \ (_| (_| | |_) |  __/ | |_| | | |  __/ | |  | | (_| |/ /  __/
 |______|___/\___\__,_| .__/ \___|  \__|_| |_|\___| |_|  |_|\__,_/___\___|
                      | |                                                 
                      |_|                                                 
