111111111111111111111111111111111111111111111111111111111111111111111111111111111
120000000000101010001000000010101000000010000010100000100010000000001000101000001
101110111111101010111010111010101110101110111110111010111010111111101011101110111
100010000000101000001010101000001000101000101010000010000010000010001000000010001
101011111011101011101011101011101010101011101010111111111111101011101010101011101
101000101010101010001000001010000010101000000000101010000010001010000010101000001
101110101110101110101010111011111111111111101110101010111011111111111110111111101
100010000000001000101010001000101000001010100010000010001000101000000010001000001
111010111111101010101011111111101011111010111110111010101110101111101110111010111
100010000010000010100010001000100010001000000000001000100010001010000010101010001
111011111111101110111010111110111010111110111011111010111011101010101110101110111
101010000010101000100000001010100000100010100010101010100000100010100000001000001
101010111110101010111011111010101111111011111110101111101110101111111011111111101
101000001000101010101010101000000010100010000010000010101000101000101010100000001
101011111110111111101010101110101110111011101111111010111011111011101110111111101
100000100000001000100010000010100000001000001000100000100000000000100010001000101
101110111011101011111110111010111111111110111110111110111111101110101110101011101
101000100010001000001000101000001010000010000000100000101000001000101010101000001
101110101111101010101011101111101011111011101110111011101110111110101010101010101
101000000010101010100000100000000000100000000010000000000000100010000000100010101
101011111010101110111110101011111011111010101011111010111010101010111111101110101
101010001010000010000010101010000010001010101000001010001010101000001000001000101
101110101011101110111110101111101111101010111110111110111110111010111011111011101
101000100000101000101010101000100000000010101010101010001010001010001010001010001
101011111110111011101011101010111110101110101011101010101011111110111111101111101
101000001010100000000000101010001010100010001010000000100010000000101000100000101
101110111011101111111110101011111011101110101011111110111110101111101110101010101
101010000000100010000010101010001000101000101010000000100000100010000010101010101
101010111111101110101111101011101010111011101011101110101011101110111010101110101
100010000000001000100000000010000010000010000010001000101000100010100000000010001
111111111111111111111111111111111111111111111111111111111111111111111111111111131
