11111111111111111111111111111111111111111
12000010001000001000001000000010001000001
11111011101011111010111110111110111110101
10000010000010000010101000000010000010101
10111011101111111011101011101111101010111
10100000000000101000001010000010001000001
10111010111111101011101010111011101110111
10101010100000000010000010101000100010101
10101111111010111011111011101110101110101
10000010100010001010000010101000001000001
10101110111110111011111010101110111011101
10100000001000101010000000001000001010001
10111010101111101111101110111110101111101
10101010100000101000000010001000101010001
10101111101110101110111110111111111011101
10100000001000000000100000100000000010001
11111110101111111110111111111110111011111
10001000100000000010100010000010100000001
10111011111111101010111010111111111010111
10001000101010101010100000000000001010101
10111011101010111111111010111111101110101
10000010000000101000001010000010000000101
11101111111011101110111110111111101011101
10000000000010001010000000001010001010001
11111010101010111010101111101010101010111
10001010101000001000100000101000101000001
11101111111011101110111010101111111010101
10000000000000101010100010100010101010101
11111011101111111011101010111110101011111
10100010000000100000001010000010001000001
10101111111011111110111110111111101111101
10100000100010001010000010001000100000101
10101011111010111011111010111010101010101
10001010001000000000101010001010001010001
10111111101110111110101111111111111110101
10000010000000000010001000000000100000101
10111110111111101111111110111110111011101
10001010101010000000000000001000001000101
10101011101010111111111110111110101011101
10101000000000000000001000100000100010001
11111111111111111111111111111111111111131
