111111111111111111111
120000000010100000001
111011111010101110101
100000100000001010101
111011101111111011101
101000100010100000101
101110111110101010101
100000000000001010101
101011111110111111111
101000101000000010001
111111101010101111101
101000001010100010001
101010101110101110101
101010100010100010101
101110111110111010111
100000000000001010001
101111101010101010111
100010101010101000001
111010101010111011101
100010001010100000101
111111111111111111131
