11111111111111111111111111111111111111111
10000000100000101000001000000000001000001
10111010101110101111101111101111111011111
10001010101000000000000000100000001000101
10111010111011101110101010111011101010101
10101010001010000010101010000000100010001
10101110101011111011111110101111101110101
10001010100000100000101000100000101010101
10111011111110111010101011111111111010101
10001000101000100010101000101000100000101
10111110101110111011101111101011111011101
10000000001000001000100010000000000010001
10101010111111111110101111111011111111111
10101010000010001000000000100010100010001
10111111101111101011111010111010111011101
10101000000000001000100010000000001000001
11101111101110111111101111101111111011101
10100000000010000000000000100000000000101
10111111111011111111101110101110101011101
10000000101010000000100010100010101010001
10111010101110111110101111111011111111101
10001010100000001000001000000010000010001
10111110101011111110111110111010111011101
10001000001000000010000010100010001010101
10111011111110101110111010111010111110111
10001010100010101010001010001000101010001
10111110111010101011101111101110101010101
10000010001010100000100010101010100010101
11111010111010111011111110111010101111101
10000010000000001000000000000000000000001
111111111111111111111111111111111111111314
