1111111111111111111111111111111
1000000010100010100010001000001
1010111010101010101011101011101
1010001000001000101010100000101
1110111110111110101110101111101
1000101000000010000010001000001
1011101111111111101011101011111
1010001010001000101010001000001
1011101010111011101110111111111
1000100000001010100000000000001
1011101111111010111110111111111
1000100000001010000000100000001
1010101111101010101011101110111
1010101010001000101010001010101
1011111010101111111111101010101
1000000000100000000000101000001
1011111111101111111010101110101
1010000000101010000010101000101
1011101111101010111111101111101
1000001010001010000000001000001
1111101011111010111110111011101
1000000000100010101000001000101
1011111011101010101011101111101
1000001000101000101000100010001
1011111110101011101011111111101
1010100000101000100010000010001
1010101110111011111010111011101
1010101000100010001000001010001
1010111010111110101010111010101
1000001010000010100010001010101
11111111111111111111111111111314
