111111111111111111111111111111111111111111111111111111111
100010101010000010000010000000100000001000000000001000001
101010101011101110101011111110111010101010101011101111101
101010001010100000101010000010100010100010101010101000001
101111101010111011111110111110101110111011101010101010111
100010100000100000101000000000101000101010001010100010001
111010101110101010101011111011111011101110111010111011101
100010000010001010000000101000100000100010001010000010101
101010111110111111111011101010111011101111101110101110101
101000100000100000000000001010100000001010100010100010001
111010101011111111101011111011111010111010111111101110111
100010101000101000101000001010000010000000000000001000001
101110111011101011101111101010101010101111111110111110101
100010100010001000101000001010101010100010000010001000101
101111111110101011101110101010111111101011101111101111101
101000100010101000001000101000101010101000101000101000001
101010111010111110111110111111101010101011101011101110111
100010000000000010001010001000101000101010001010100010001
111110101010101110111011101110101110111011101010111010111
101000101010100010000010001000001000001000101000000010101
101110111011101111101110111110101110101110101011111111101
100010100000101000000010000010100010100010000000100000101
101111101111101011111110111111101111111011111010111011101
100000000000100000101010000000000010000010101010000000001
111110111011111011101011111011101111111010101111111110111
101000001000001010001010001010100000000000101000001000101
101110111011111010111010111010111011101110101011101110101
100000100010100000000010000000101010101000001010001000001
101111101010101011111010101010101110101111111011111011101
100010001010001000001000101010000010000000000000000000101
1111111111111111111111111111111111111111111111111111111314
